A . . . . . . . . . . . . . . .
. # # # . . . . . . . . . . . .
. . # . . . . . . . . . . . . .
G . # 1 9 . . . . . . . . . . .
. . . . . # # # . . . . . . . .
. . . . . # . # . . . . . . . .
. . . . . # . # . . . . . . . G
. . . . . # . # . . . . . . . .
. . # . . . . . # # # . . . . .
. . . . . . . . # . . . . . # .
. . . . . . . . # . . # . . # .
. . . . . . . . # . . # . . # .
. . . . . . . . . . . # . . # .
. . . . . . . . . . . # # # # .
. . . . . . . . . . . . . . # .
. . . . . . . . . . . . . . . .