A . . 1 9 . . .
G # # . . . . .
. . # . . . . .
. . # . . . . .
. G . . . . . .
. . . . . . . .
. . . . . . . .
. . . . . . . .